NO ./textures/wolfenstein/grey_stone.xpm
SO ./textures/wolfenstein/purple_stone.xpm
WE ./textures/wolfenstein/red_brick.xpm
EA ./textures/wolfenstein/wood.xpm

F 20,20,20
C 200,200,200

11111
10001
10S01
11P11
11P11
11P11
11P11
1000P
10001
10001
10001
10001
11111