NO ./textures/north_texture.xpm
EA ./textures/east_texture.xpm
SO ./textures/south_texture.xpm
WE ./textures/west_texture.xpm

F 20,20,20
C 200,200,200

11111111111111     11111111111
10000000000001     10000000001
10000000000001     10000000001
100000000000011111110000000001
100000000000011111110000000001
100000000000000000000000000001
100000000000000000000000000001
100000000000000000000000000001
1000000000000111S1110000000001
11111111111111     11111111111
10000000000001     10000000001
10000000000001     10000000001
11111111111111     11111111111